ABORT	AH B AO R T
BACK	B AE K
BACKWARD	B AE K W ER D
COME	K AH M
CONTINUE	K AH N T IH N Y UW
DOWN	D AW N
FASTER	F AE S T ER
FORWARD	F AO R W ER D
FULL	F UH L
GO	G OW
HALF	HH AE F
HALT	HH AO L T
LEFT	L EH F T
MOVE	M UW V
PAUSE	P AO Z
QUARTER	K W AO R T ER
QUARTER(2)	K AO R T ER
RIGHT	R AY T
ROTATE	R OW T EY T
SLOW	S L OW
SLOWER	S L OW ER
SPEECH	S P IY CH
SPEED	S P IY D
STOP	S T AA P
TURN	T ER N
UP	AH P
